..............................................
.##################$########################..
.#........#...#.....#...#........#...#.....#..
.#######..#.#.#..##############..#.#.#..####..
.#..........#....#......#..........#.......#..
.#....###############...#....###############..
.###.##....@...#.#..###.###.##....##.#..#..#..
.#....#....#...#.#..#...#....#....#..#.##..#..
.###.###..####...##....####.##.#.##.....#..#..
.##......##....#....#.#.##......##....##.###..
.#..#..##########...#.#.####..##########...#..
.#.###.....#..###...#.###.###.....#..###...#..
.#...##.##.#..#####...#.....##.##.#..#####.#..
.###.##.#.....###..##.#.###..#.#..#..###..##..
.###......##.####.###...####.....##.####.###..
####$###########################$###########..



