...###..............
..##...####.........
.##..###..#.........
##..................
#...@..#............
###..###..#.........
..#..#....#.........
.##.##.#.##.........
.#......##..........
.#..................
.###................
.###................
.###.###............
.###................
.#######............
.#######............